Badestrender i nærheten av Oslo-området

http://www.yr.no/observasjonar/badetemperaturar.html

Saltvann
========
Solvikbukta, Malmøya	Oslo			
Nordstrand bad	Oslo			
Katten	Oslo			
Hvervenbukta	Oslo	
Gressholmen	Oslo		
Hovedøya	Oslo		
Sjøstrand	Asker		
Storøyodden	Bærum		
Ingierstrand	Oppegård			
Bestemorstranda	Oppegård			
Bekkensten	Oppegård		
Langøyene	Nesodden		
Hvalstrand	Asker			
Kadettangen	Bærum			
Ulvøya, Sydstranda
Huk	Oslo		
Tjuvhomen Oslo	
Holmenskjæret Asker

Ferskvann
============
Stensrudtjern	Oslo		
Sognsvann	Oslo			
Trollvann	Oslo			
Svarttjern	Oslo			
Vesletjern	Oslo			
Kapteinsputten	Oslo		
Steinbruvann	Oslo		
Badedammen ved Grorud	Oslo	
Ulsrudvann	Oslo			
Skraperudtjern	Oslo			
Nøklevann	Oslo			
Lutvann	Oslo			